10,7
3,3,3,3,3,3,3,3,3,3
3,1,1,1,1,1,1,1,1,3
3,1,1,9,1,1,10,1,1,3
3,6,6,6,6,6,6,6,6,3
3,1,1,1,1,1,1,6,6,3
3,1,1,1,1,1,1,6,6,3
3,3,3,3,3,3,3,6,6,3